Add - Subtract|
Above - Below|
After - Before|
Awake - Asleep|
Bad - Good~
Better - Worse|
Big - Little|
Birth - Death|
Boy - Girl|
Clean - Dirty~
Close - Open|
Cold - Hot|
End - Begin|
Dark - Light|
Day - Night~
Even - Odd|
Fail - Pass|
False - True|
Float - Sink|
East - West~
Fat - Skinny|
Hungry - Full|
Gentle - Rough|
Happy - Sad|
Hard - Soft~
Heavy - Light|
High - Low|
In - Out|
Last - First|
Laugh - Cry~
Learn - Teach|
Less - More|
Lie - Truth|
Long - Short|
Loose - Tight~
Lost - Found|
Love - Hate|
North - South|
On - Off|
Over - Under~
Play - Work|
Polite - Rude|
Poor - Rich|
Present - Absent|
Top - Bottom~
Quick - Slow|
Raise - Lower|
Right - Wrong|
Rise - Sink|
Rough - Smooth~
Same - Different|
Sell - Buy|
Short - Long|
Sour - Sweet|
Start - Stop~
Stay - Leave|
Stop - Go|
Strong - Weak|
Teacher - Student|
Tidy - Messy~
True - False|
Ugly - Beautiful|
Up - Down|
White - Black|
Wild - Tame~

